11111111111111111111111111111111111111111111111111
10000000000000000000000000000000000000000000000001
10000000000000000000000000000000000000000000000001
10000000000000000000111100011111110001100000000001
10000000000000000000100000000000000000100000000001
10000000000000000000100000000000000000100000000001
10000000000000000000100000000000000000100000000001
10000000000000000000111111111111111111100000000001
10000000000000000000000000000000000000000000000001
10000000000000000000000000000000000000000000000001
10000000000000000000111111111111111111100000000001
10000000000000000000000000000100000000000000000001
10000000000000000000000000000100000000000000000001
10000000000000000000100000000000000000000000000001
10000000000000000000111111111111111111100000000001
10000000000000000000000000000000000000000000000001
10000000000000000000000000000000000000000000000001
10000000000000000000000000000000000000000000000001
10000000000000000000000000000000000000000000000001
10000000000000000000000000000000000000000000000001
10000000100000000000000000000000000000000000000001
10000000100000000000000000000000000000000000000001
10000000100000000000000000000000000000000000000001
10000000100000000001111000000000000000000000000001
10000000111110000000001000000000000000000000000001
10000000000000000000001000000000000000000000000001
10000000000000000000001000000000000000000000000001
10000000000000000000001111111000000000000000000001
10000000000000000000000000000000000000000000000001
10000000000000000000000000000000000000000000000001
10000000000000000000000000000000000000000000000001
10000000000000000000000000000000000000000000000001
10000000000000000000000000000000000000000000000001
10000000000000000000000000000000000000000000000001
10000000000000000000000000000000000000000000000001
10000000000000000000000000000000000000000000000001
10000000000000000000000000000000000000000000000001
10000000000000000000000000000000000000000000000001
10000000000000000000000000000000000000000000000001
10000000000000000000000000000000000000000000000001
10000000000000000000000000000000000000000000000001
10000000000000000000000000000000000000000000000001
10000000000000000000000000000000000000000000000001
10000000000000000000000000000000000000000000000001
10000000000000000000000000000000000000000000000001
10000000000000000000000000000000000000000000000001
10000000000000000000000000000000000000000000000001
10000000000000000000000000000000000000000000000001
10000000000000000000000000000000000000000000000001
11111111111111111111111111111111111111111111111111

